tiles.png
0,0 1,0 0,0 1,0 0,0 1,0 0,0 1,0 0,0 1,0 0,0 1,0 0,0 1,0 0,0 1,3 5,1 7,1 0,3 1,0 0,0 1,0 0,0 1,0 0,0 1,0 0,0 1,0 0,0 1,0 0,0 1,0
1,0 0,0 1,3 0,3 1,3 0,3 1,3 0,3 1,3 0,3 1,3 0,3 1,3 0,3 1,3 5,3 5,1 7,1 5,3 0,3 1,3 0,3 1,3 0,3 1,3 0,3 1,3 0,3 1,3 0,3 0,1 1,1
0,0 1,3 5,3 5,3 5,3 5,3 5,3 5,3 5,3 5,3 5,3 5,3 5,3 5,3 5,3 5,3 5,1 7,1 5,3 5,3 5,3 5,3 5,3 5,3 5,3 5,3 5,3 5,3 5,3 5,3 0,3 1,0
1,0 1,2 5,3 0,4 1,4 2,4 3,4 5,3 5,3 5,3 5,3 5,3 5,3 0,2 1,2 5,3 5,1 7,1 5,3 5,3 5,3 5,3 5,3 5,3 5,3 5,3 5,3 5,3 5,3 5,3 0,2 1,1
0,0 1,3 5,3 0,5 1,5 2,5 3,5 5,3 5,3 5,3 5,3 5,3 5,3 0,3 1,3 5,3 5,1 7,1 5,3 5,3 5,3 5,3 5,3 5,3 5,3 5,3 5,3 5,3 5,3 5,3 0,3 1,0
1,0 1,2 5,3 0,6 1,6 2,6 3,6 5,3 5,3 5,3 5,3 5,3 5,3 5,3 5,3 5,3 5,1 7,1 5,3 5,3 5,3 5,3 5,3 5,3 5,3 5,3 5,3 5,3 5,3 5,3 0,2 1,1
0,0 1,3 5,3 0,7 1,7 2,7 3,7 5,3 5,3 5,3 5,3 5,3 5,3 5,3 5,3 5,3 5,1 7,1 5,3 5,3 5,3 0,2 1,2 2,0 3,0 4,0 5,3 5,3 5,3 5,3 0,3 1,0
1,0 1,2 5,3 5,3 5,0 6,0 6,0 6,0 6,0 6,0 6,0 6,0 6,0 6,0 6,0 6,0 6,1 6,1 6,0 6,0 7,0 0,3 1,3 2,1 3,1 4,1 5,3 5,3 5,3 5,3 0,2 1,1
0,0 1,3 5,3 5,3 5,2 6,2 6,2 6,2 6,2 6,2 6,2 6,2 6,2 6,1 6,1 6,2 6,2 6,2 6,2 6,1 7,1 0,2 1,2 2,2 3,2 4,2 5,3 5,3 5,3 5,3 0,3 1,0
1,0 1,2 5,3 5,3 5,3 5,3 5,3 5,3 5,3 5,3 5,3 0,2 1,2 5,1 7,1 4,4 5,4 6,4 5,3 5,1 7,1 0,3 1,3 2,3 3,3 4,3 5,3 5,3 5,3 5,3 5,3 0,3
0,0 1,3 5,3 5,3 5,3 5,3 5,3 5,3 5,3 5,3 5,3 0,3 1,3 5,1 7,1 4,5 5,5 6,5 5,3 5,1 6,1 6,0 6,0 6,0 6,0 6,0 6,0 6,0 6,0 6,0 6,0 6,0
1,0 1,2 5,3 5,3 5,3 5,3 5,3 5,3 5,3 5,3 5,3 5,3 5,3 5,1 7,1 4,6 5,6 6,6 5,3 5,1 6,1 6,2 6,2 6,2 6,2 6,2 6,2 6,2 6,2 6,2 6,2 6,2
0,0 1,3 5,3 5,3 5,3 5,3 5,3 5,3 5,3 5,3 5,3 5,3 5,3 5,1 7,1 4,7 5,7 6,7 5,3 5,1 7,1 5,3 5,3 5,3 5,3 0,2 1,2 5,3 5,3 5,3 5,3 0,2
1,0 1,2 5,3 5,3 5,3 5,3 2,0 3,0 4,0 5,3 5,3 5,3 5,3 5,1 6,1 6,0 6,0 6,0 6,0 6,1 7,1 5,3 5,3 5,3 5,3 0,3 1,3 5,3 5,3 5,3 0,2 1,1
0,0 1,3 5,3 5,3 5,3 5,3 2,1 3,1 4,1 5,3 5,3 5,3 5,3 5,1 6,1 6,2 6,2 6,2 6,2 6,1 7,1 5,3 5,3 5,3 5,3 5,3 5,3 5,3 5,3 5,3 0,3 1,0
1,0 1,2 5,3 5,3 5,3 5,3 2,2 3,2 4,2 5,3 5,3 5,3 5,3 5,1 7,1 0,2 1,2 0,2 1,2 5,1 7,1 5,3 5,3 5,3 5,3 5,3 5,3 5,3 5,3 5,3 0,2 1,1
0,0 1,3 5,3 5,3 5,3 5,3 2,3 3,3 4,3 5,3 5,0 6,0 6,0 6,1 7,1 0,3 1,3 0,3 1,3 5,1 7,1 5,3 5,3 5,3 5,3 5,3 5,3 5,3 5,3 5,3 0,3 1,0
1,0 1,2 5,3 5,3 5,3 5,3 5,0 6,0 6,0 6,0 6,1 6,1 6,2 6,1 6,1 6,0 6,0 6,0 6,0 6,1 7,1 5,3 5,3 0,2 1,2 0,8 1,8 2,8 5,3 5,3 0,2 1,1
0,0 1,3 5,3 5,3 5,3 5,3 5,2 6,2 6,2 6,2 6,2 7,2 5,3 5,2 6,1 6,2 6,2 6,2 6,2 6,1 7,1 5,3 5,3 0,3 1,3 0,9 1,9 2,9 5,3 5,3 0,3 1,0
1,0 1,2 5,3 0,2 1,2 5,3 5,3 5,3 5,3 5,3 5,3 5,3 5,3 5,3 5,3 5,3 5,3 5,3 5,3 5,1 6,1 6,0 6,0 6,0 6,0 6,0 7,0 5,3 5,3 5,3 0,2 1,1
0,0 1,3 5,3 0,3 1,3 5,3 5,3 5,3 5,3 5,3 5,3 5,3 5,3 5,3 5,3 5,3 5,3 5,3 5,3 5,2 6,2 6,2 6,2 6,2 6,2 6,2 7,2 5,3 5,3 5,3 0,3 1,0
1,0 1,2 5,3 5,3 5,3 5,3 5,3 5,3 5,3 5,3 5,3 5,3 5,3 5,3 5,3 5,3 5,3 5,3 5,3 5,3 5,3 5,3 5,3 5,3 5,3 5,3 5,3 5,3 5,3 5,3 0,2 1,1
0,0 1,3 5,3 5,3 5,3 5,3 5,3 5,3 5,3 5,3 5,3 5,3 5,3 5,3 5,3 5,3 5,3 5,3 5,3 5,3 5,3 5,3 5,3 5,3 5,3 5,3 5,3 5,3 5,3 5,3 0,3 1,0
1,0 1,2 0,2 1,2 0,2 1,2 0,2 1,2 0,2 1,2 0,2 1,2 0,2 1,2 0,2 1,2 0,2 1,2 0,2 1,2 0,2 1,2 0,2 1,2 0,2 1,2 0,2 1,2 0,2 1,2 0,2 1,1  
0,0 1,0 0,0 1,0 0,0 1,0 0,0 1,0 0,0 1,0 0,0 1,0 0,0 1,0 0,0 1,0 0,0 1,0 0,0 1,0 0,0 1,0 0,0 1,0 0,0 1,0 0,0 1,0 0,0 1,0 0,0 1,0  